11111111111
10100000001
10000000001
10000000001
10001100001
10010000001
10010000001
10010000001
10010000001
10000000001
11111111111