11111111
10100001
10000001
10000001
10001101
10010001
10000001
11111111