11111111
1000V001
1000V101
1010VVV1
10010001
10000101
10000001
11111111