NO /home/tmalless/Documents/Cub3d/CUB3D_FF/textures/green1.xpm
SO /home/tmalless/Documents/Cub3d/CUB3D_FF/textures/green2.xpm
WE /home/tmalless/Documents/Cub3d/CUB3D_FF/textures/green3.xpm
NO
NO
EA /home/tmalless/Documents/Cub3d/CUB3D_FF/textures/green4.xpm
F   9,5,210
C   249,5,8






111111111111111111111111111111
1               
1 111111111111111111111
1 10000000000000000001
1 100000000000000S00001
1  1000000000000000001
1  1000000000000000001
1 1111111111111111111
1
11111 111111111111111111 1111111111
1       1 11111111111111 111111111
 1     1
  1   1
   1 
   1
    1