NO t
SO t
WE t
NO
NO
EA t
F   9,5,888






111111111111111111111111111111
1                                  
1 111111111111111111111
1 1000000000000W000001
1 10000000000000000001
1  1000000000000000001
1  100000000000000001
1 1111111111111111111
1
11111 111111111111111111 1111111111
1       1 11111111111111 111111111
 1     1
  1   1
   1 
   1
    1