NO ./maps/texture/lava.xpm
SO ./maps/texture/lava.xpm
EA ./maps/texture/caution_stripes_seamless.xpm
WE ./maps/texture/caution_stripes_seamless.xpm

F  0, 0, 0
C 255, 20, 30

1111111111111111111111111111111111111111111111111111111111111111111111111111111111111111111111111111111111111111111
1N000000000000000000000000000000000000000000000000000000000000000000000000000000000000000000000000000000000000000001
10000000000000000000000000000000000000000000000000000000000000000000000000000000000000000000000000000000000000000001
10000000000000000000000000000000000000000000000000000000000000000000000000000000000000000000000000000000000000000001
10000000000000000000000000000000000000000000000000000000000000000000000000000000000000000000000000000000000000000001
10000000000000000000000000000000000000000000000000000000000000000000000000000000000000000000000000000000000000000001
10000000000000000000000000000000000000000000000000000000000000000000000000000000000000000000000000000000000000000001
10111111111111111111111111111111111111111111111111111111111111111111111111111111111111111111111111111111111111111111111
1000001
1100001
1001101
1000001
1001111
1000001
1000001
1000001
1000001
1110001
1000001
1000001
1000001
1000001
1001001
1000001
1000001
1000001
1000001
1000001
1000001
1000001
1000001
1000001
1000001
1000001
1000001
1000001
1000001
1000001
1000001
1000001
1000001
1000001
1000001
1000001
1010001
1000001
1000001
1000001
1000001
1000001
1001001
1000001
1000001
1000001
1000001
1000001
1000001
1000001
1000001
1000001
1110001
1000001
1000001
1000101
1000001
1000001
1001001
1000001
1000001
1000001
1000001
1010001
1000001
1000001
1000001
1000101
1000001
1000001
1001001
1000001
1000001
1000001
1000001
1000001
1000101
1010001
1000001
1000001
1000001
1111111
1
1
1
1
1

