NO ./maps/texture/green1.xpm
SO ./maps/texture/green2.xpm
EA ./maps/texture/green3.xpm
WE ./maps/texture/green4.xpm

F 60,200,5
C 125,255,55

        111111111111111111111111111111111111111111111111111111111111111111111111111
        1000000000110000000000000000000000000000000000000000000000001
        1011000001110000000000000000000000000000000000000000000000001
        100100000000000000S000000000000000000000000000000000000000001
111111111011000001110000000000000000000000000000000000000000000000001
100000000011000001110111110111110000000000000000000000000000000000001
1111011111111101110000001000111111111111111111111111111111111111111111111111111
11110111111111011101010010001
11000000110101011100000010001
10000000000000001100000010001
10000000000000001101010010001
1100000111010101111101111000111
11110111 1110101 101111010001
11111111 1111111 111111111111
