NO ./maps/texture/lava.xpm
SO ./maps/texture/lava.xpm
EA ./maps/texture/caution_stripes_seamless.xpm
WE ./maps/texture/caution_stripes_seamless.xpm

F  0, 0, 0
C 255, 20, 30

111111111111111111111111111111111111111111111111111111111111111111111111111111111111111111111111111111111111111111111111111111111111111111111111111111111111111111111
1W0000000000000000000000000000000000000000000000000000000000000000000000000000000000000000000000000000000000000000000000000000000000000000000000000000000000000000001
111111111111111111111111111111111111111111111111111111111111111111111111111111111111111111111111111111111111111111111111111111111111111111111111111111111111111111111