C 255, 20, 30

NO ./textures/green1.xpm
SO ./textures/green2.xpm
EA ./textures/green3.xpm
WE ./textures/green4.xpm

F  0, 0, 0



111111111111111111111111111111
11111111100000000000000011111
100000000000000000111000100001
110000100000000000000000001111
10000111111100000000000111111
1111111000000000W0000000000001
11110000000000110000000000011
10000000000000000000000000001
110000000000011110000000000011
100000000000111000000000000011
11000000000011100000000000111100
110000000001111000000000000111
111111111111111111111111111111111
