NO ./maps/texture/eagle.xpm
SO ./maps/texture/greystone.xpm
EA ./maps/texture/red.xpm
WE ./maps/texture/purplestone.xpm

F 0,0,255
C 0,255,255

11111111
10000001
10000101
10101101
10010001
10000101
10N00001
11111111