NO ./maps/texture/eagle.xpm
SO ./maps/texture/caution_stripes_seamless.xpm
EA ./maps/texture/red.xpm
WE ./maps/texture/purplestone.xpm

F 0,0,255
C 0,255,255



11111111
1000V001
1000V101
1010VVV1
10010001
10000101
10N00001
11111111