NO ./maps/texture/lava.xpm
SO ./maps/texture/lava.xpm
EA ./maps/texture/caution_stripes_seamless.xpm
WE ./maps/texture/caution_stripes_seamless.xpm

F  0, 0, 0
C 255, 20, 30

1111111111111111111111111111111111111111111111111111111111111111111111111111111111111111111111111111111111111111111
1N000000000001000000000000000000000000000000000000000000000010000000000000000000000000000000000000000000000000000001
10000000000001000000000000000000000000000000000000000000000010000000000000000000000000000000000000000000000000000001
10000000000111000001000000000000000000000000000000000000000010000000000000000000000000000000000000000000000000000001
100000000000000000010000000000000000000000000000000000000000V0000000000000000000000000000000000000000000000000000001
10000000000000000001000000000000000000000000000000000000000010000000000000000000000000000000000000000000000000000001
10000000000000000001000000000000000000000000000000000000000010000000000000000000000000000000000000000000000000000001
11111111111111111111111111111111111111111111111111111111111111111111111111111111111111111111111111111111111111111111111
